6 7
1 1 1 1 1 1 0
1 5 0 0 0 1 1 
1 0 2 2 0 0 1 
1 0 1 3 0 3 1 
1 0 0 0 0 0 1 
1 1 1 1 1 1 1 