8 12
5 5 5 5 5 5 1 1 1 1 1 5
5 5 5 5 5 5 1 0 0 0 1 5
1 1 1 1 5 5 1 0 1 0 1 1
1 0 0 1 1 1 1 0 0 0 0 1
1 3 2 0 0 0 0 0 0 1 0 1
1 3 2 1 1 1 1 1 0 0 0 1
1 6 0 1 5 5 5 1 1 1 1 1
1 1 1 1 5 5 5 5 5 5 5 5