9 8
5 5 1 1 1 1 1 5
1 1 1 0 0 0 1 5
1 3 6 2 0 0 1 5
1 1 1 0 2 3 1 5
1 3 1 1 2 0 1 5
1 0 1 0 3 0 1 1
1 2 0 4 2 2 3 1
1 0 0 0 3 0 0 1
1 1 1 1 1 1 1 1