11 22
5 5 5 5 1 1 1 1 1 1 1 5 5 5 5 5 5 5 5 5 5 5
5 5 5 5 1 0 0 0 0 0 1 5 5 5 5 5 5 5 5 5 5 5
5 5 5 5 1 2 0 0 0 0 1 5 5 5 5 5 5 5 5 5 5 5
5 5 1 1 1 0 0 0 0 0 1 5 5 5 5 5 5 5 5 5 5 5
5 5 1 0 0 2 0 0 2 0 1 5 5 5 5 5 5 5 5 5 5 5
1 1 1 0 1 0 1 1 1 0 1 5 5 5 5 5 1 1 1 1 1 1 
1 0 0 0 1 0 1 1 1 0 1 1 1 1 1 1 1 0 0 3 3 1 
1 0 0 0 0 2 0 0 0 0 0 0 0 0 0 0 0 0 0 0 3 1 
1 1 1 1 1 0 1 1 1 1 0 1 6 1 1 1 1 0 0 0 3 1 
5 5 5 5 1 0 0 0 0 0 0 1 1 1 5 5 1 1 1 1 1 1 
5 5 5 5 1 1 1 1 1 1 1 1 5 5 5 5 5 5 5 5 5 5