7 7
5 5 1 1 1 1 5
1 1 1 0 0 1 5
1 6 0 3 2 1 1 
1 0 0 0 2 0 1 
1 0 1 3 0 0 1 
1 0 0 0 0 0 1 
1 1 1 1 1 1 1