8 8
0 1 1 1 1 1 1 0
1 3 2 5 0 0 1 0
1 1 1 0 0 0 1 0
1 3 1 1 0 0 1 0
1 0 1 0 0 0 1 1
1 2 0 4 2 0 0 1
1 0 0 0 1 0 0 1
1 1 1 1 1 1 1 1