8 8
5 1 1 1 1 1 1 5
1 3 2 6 0 0 1 5
1 1 1 0 0 0 1 5
1 3 1 1 0 0 1 5
1 0 1 0 0 0 1 1 
1 2 0 4 2 0 0 1 
1 0 0 0 3 0 0 1 
1 1 1 1 1 1 1 1 

