10 7
1 1 1 1 1 1 0
1 0 0 0 0 1 0
1 2 0 0 2 1 0
1 0 0 0 0 1 0 
1 2 0 0 2 1 0
1 3 0 5 3 1 0
1 3 0 2 3 1 0
1 3 0 2 3 1 0
1 0 0 0 0 1 0 
1 1 1 1 1 1 0