6 8
1 1 1 1 1 1 1 1 
1 0 0 0 0 0 0 1 
1 0 3 4 4 2 5 1 
1 0 0 0 0 0 0 1 
1 1 1 1 1 0 0 1 
0 0 0 1 1 1 1 0