7 6
1 1 1 1 5 5
1 0 3 1 5 5
1 0 0 1 1 1
1 4 6 0 0 1
1 0 0 2 0 1
1 0 0 1 1 1
1 1 1 1 5 5