9 9
5 5 5 5 1 1 1 1 1 
5 5 1 1 1 6 0 0 1 
5 5 1 3 0 2 0 3 1 
5 5 1 0 0 2 0 1 1 
5 1 1 1 0 1 1 1 5
1 1 0 2 0 0 1 5 5
1 0 0 0 0 0 1 5 5
1 3 0 0 1 1 1 5 5
1 1 1 1 1 5 5 5 5